                  
 -------          
 |.....|      ----
 |.....########..|
 |.....|     --..|
 |.....|     |...|
 ---#---     |...|
    #        |..--
    #        --#- 
   -#-----     #  
 ---     ----  #  
 |..........|  #  
 |..........|  #  
 |..........|  #  
 |..........|  #  
 |..........|  #  
 |..........|  #  
 |..........|  #  
 --------#---  #  
         #     #  
         #######  
